%%%%%%%%%%%%%%%%%%%%%%%%%%%%%%%%%%%%%
% ....  % % %           %   %     %.%
% %%%%%%% % %%% % %%% %%% %%%%%%% % %
%       %   ... % %     %     % %   %
%%%%% %%%%% %%% % % % %%% %%%%% % %%%
%   % % % %   % % % %   % %   % % . %
% %%% % % % %%% %%%%% %%% % %%% %%% %
%       %     %   %   %     % % %   %
%%% %%%%%%%%% %%%%%%% %%% %%% % % % %
%             %       % %   %     % %
% % %%%%% % %%% % % %%% % %%% %%% % %
% % %     % % % % %     %   % % % % %
% % % %%%%%%% % %%%%%%%%% %%% % %%% %
% % % %     %   %     %     %   %   %
%%% %%% % %%%%% %%%%% %%% %%% %%%%% %
%     % % %     % %     % %   % % % %
% % % % % %%% %%% %%% %%% % % % % % %
% % % % %       .....     % % %     %
%%% %%%%%%% % % %%%%% %%% % %%% %%%%%
%       % % % %     %   %     % %   %
%%%%% % % %%%%%%%%% %%%%%%%%%%% % %%%
%   % %.         .% %  .  %   % %   %
% %%% %%%%% %%%%%%%%% %%%%% % % %%% %
% %   %      %        %     %       %
% % % %%%%% %%% % % % % %%%%%%%%%%%%%
% % %   %     % % % %       %   % % %
% % %%% %%% % % % %%%%%%%%% %%% % % %
% %   % %   % % %   % %   % % %     %
% %%% %%% %%%%% %%% % % %%%%% % %%%%%
%  ...  % ..%     % %     %   % %   %
%%% % %%%%% %%%%% %%% %%% % %%% % %%%
% % % % % % % %     % %   % %   % % %
% % %%% % % % % %%%%%%%%% % % % % % %
%   %   %   %                 %     %
% % % % %%% %%% %%%%%%% %%% %%% %%% %
%.% % %       %   %  ...  %   % %  P%
%%%%%%%%%%%%%%%%%%%%%%%%%%%%%%%%%%%%%