%%%%%%%%%%%%%%%%%%%%
%.   %     .  %    %
% %% % %%%%%% % %% %
% %      .       % %
% % %% %%  %% %% % %
%      %    %     .%
% % %% %%%%%% %% % %
% %              % %
% %% % %%%%%% % %% %
%.    %   P    %   %
%%%%%%%%%%%%%%%%%%%%